0,0,0,r,0,0,0,0,0,0
0,0,0,0,0,0,0,0,0,0
0,0,0,0,0,0,0,0,0,0
0,0,0,0,0,0,0,0,0,0
0,0,0,0,0,0,0,0,0,0
0,0,0,0,0,0,0,0,0,0
S,0,0,0,^,0,0,0,0,0
0,0,0,<,0,>,0,0,0,E
0,0,0,0,0,0,0,0,0,0
f,a,r,0,0,0,0,0,0,0
