r,0,0,r,r,0,0,r,E,r
0,0,0,r,r,0,0,r,0,r
f,0,0,0,0,0,0,0,0,v
0,0,r,0,0,0,f,0,0,0
0,0,0,0,0,0,0,0,0,0
0,0,0,0,0,r,0,r,r,0
0,0,0,r,r,0,0,0,0,0
>,0,0,0,0,0,0,0,0,0
0,0,0,0,0,0,0,0,r,0
r,0,0,r,S,r,0,0,0,0
