0,v,r,r,r,r,r,r,r,0
r,0,0,0,0,0,0,0,0,<
r,0,r,r,r,r,r,r,0,r
r,0,r,0,0,0,0,r,0,r
r,0,r,0,0,0,0,r,0,r
r,0,r,0,0,0,0,r,0,r
r,E,r,0,0,0,0,r,0,r
r,r,r,r,r,r,r,r,0,r
>,0,0,0,0,0,0,0,0,r
0,0,S,r,r,r,r,r,^,0
