0,0,v,0,v,0,v,0,v,0
0,r,0,r,0,r,0,r,0,E
>,0,0,0,0,0,0,0,0,0
0,r,0,f,0,0,f,r,0,0
>,0,0,0,0,0,0,0,0,0
0,r,0,0,0,0,0,r,0,0
>,0,0,f,0,0,f,0,0,0
0,r,0,0,r,0,r,r,0,0
>,0,0,0,0,0,0,0,0,0
0,0,S,0,0,0,0,r,0,0
